_____H___W__
SSS_S_SSSS__
B___SBS__S__
____SBS__S__
_B__SSS_KS__
_________S__
_TBT_____S__
_TTT__+-_B__
_________B__
BSSSSBBSSSB_
_V_____@____
___<___>_S__